# ItemCasePE data 
114:6:133,310:0,1
112:6:133,311:0,1
110:6:133,312:0,1
108:6:133,313:0,1
106:6:133,276:0,1
104:6:131,298:0,1
104:6:129,299:0,1
104:6:127,300:0,1
104:6:125,301:0,1
104:6:123,272:0,1
106:6:122,306:0,1
108:6:122,307:0,1
110:6:122,308:0,1
112:6:122,309:0,1
114:6:122,267:0,1
