# ItemCasePE data 
161:6:134,310:0,1
161:6:133,311:0,1
161:6:132,312:0,1
161:6:131,313:0,1
161:6:130,322:0,1
161:6:124,301:0,1
161:6:125,300:0,1
161:6:126,299:0,1
161:6:127,298:0,1
167:6:125,283:0,1
167:6:126,268:0,1
167:6:127,272:0,1
167:6:131,276:0,1
167:6:132,267:0,1
167:6:133,46:0,64
170:6:128,384:0,64
170:6:129,259:0,1
170:6:130,322:0,64
172:6:125,86:0,64
172:6:126,364:0,64
172:6:127,357:0,64
172:6:131,261:0,1
172:6:132,262:0,64
